###   ##########
#        #     #
#        #     #
#        #     #
         #      
                
                 
     ##         
     #          
     #      #   
     #  #   #   
#             ##